1111111111111111111111111
1000000000000000000000001
1000000000000000000000001
1000000000000000000000001
1000011111000001111100001
1000011111000001111100001
1000011111000001111100001
1000011111000001111100001
1000011111000001111100001
1000000000000000000000001
1000000000000000000000001
1000000000000000000000001
100000000000f000000000001
1000000000000000000000001
1000000000000000000000001
1000000000000000000000001
1000011111000001111100001
1000011111000001111100001
1000011111000001111100001
1000011111000001111100001
1000011111000001111100001
1000000000000000000000001
1000000000000000000000001
1000000000000000000000001
1111111111111111111111111